11111
100E1
10111
10001
1C0P1
11111