111111111111111
10010000000C001
10C10000000C101
10010000000C001
10P001111100101
100011E00000101
10010N000011101
1001C0000C00001
1C0100C000C0001
111111111111111